2
#########
##    TT#
#TBBB ###
#  SBT###
#TBBB ###
##    TT#
#########
[metadata]
name:name1