12
############OO
#TT  #     ###
#TT  # B  B  #
#TT  #B####  #
#TT    S ##  #
#TT  # #  B ##
###### ##B B #
OO# B  B B B #
OO#    #     #
OO############
[metadata]
name:name1