8
OO########OO
O#T#    #T#O
#  #B  B#  #
#  #  B #  #
#  # BS #  #
#  T ## T  #
#  #    #  #
# B      B #
# T######T #
O##OOOOOO##O
[metadata]
name:name1