7
############O
#    ###   #O
#    T  BB #O
#  S ###   #O
# T# #T  ###O
# ## #   ####
# B  ## B T #
#       #   #
#############
[metadata]
name:name1