1
##########
#        #
#  B T#  #
# S ##T  #
# TB #B  #
#        #
##########
[metadata]
name:name1
